   ###     
  ## # ####
 ##  ###  #
## o      #
#   Ao #  #
### o###  #
  #  #++  #
 ## ##+# ##
 #      ## 
 #     ##  
 #######
