#######
#     #
# o o #
# #  ##
# +  # 
# A +# 
###### 

