  ##### 
###   # 
#+Ao  # 
### o+# 
#+##o # 
# # + ##
#oo+oo+#
#   +  #
########